||||||||||||||||||||||||||||||||||
|W.||............................|
|..||.............|...|..|.......|
|................................|
|.............|||||..||||||......|
|.............N..................|
|.|||N............|...|..|.....N.|
|..............N...............|.|
|.|||N.......||||................|
|................................|
||||||||||||||||||||||||||||||||||